1111111111111111
1P10000C00000001
101C0000000000C1
1011110000001111
101C010000000C11
1000000000CC10E1
1111111111111111