111111111111
1PC1000001E1
10C100000101
100100000001
1000000000M1
100000000001
10C000000001
111111111111