111111111111111111111111
101000000000000C10000C01
1E1001010010000110100101
101001001110101000100111
1P0000000C10C00000000001
111111111111111111111111