111111111111111111111111111111111111
1CEP00000000000000000000000000000011
111111111111111111111111111111111111