111111111111111111111111111111
1CPE00000000000000000000000001
100000000000000000000000000001
100000000000000000000000000001
111111111111111111111111111111