111111111111111111111111
1E1000000000000C10000C01
101001010010000110100101
101001001110101000100101
1P0000000C10C00000000001
111111111111111111111111