11111111111111111111
1C1P000000C0000001E1
100C0000000000000101
100000C001C100000101
10000C1001C1000100C1
11111111111111111111
10000000000000000001
11111111111111111111