111111111111111111111111
100000000000000C00000C01
1110010100100E0010100101
1110010010101010M0100101
1P0000000C00C00000001111
111111111111111111111111