111111111111111111111111
1E0000000000000C00000C01
101001010010000010100101
1010010010101010M0100101
1P0000000C00C00000000001
111111111111111111111111